.11222121
1......T.
2...TT...
1.TT.....
1........
3........
1T...TTTT
1..T.....
2.....T..