.21211203
0..T....T
3......T.
1.T......
2..T...T.
1.......T
3...T.T..
1T....T..
1..T.....